# Map file for tile-based game 
# (Lines that start with '#' are comments)
# The tiles are:
#   (Space) Empty tile
#   A..Z    Tiles A through Z
#   o       Star
#   !       Music Note
#   *       Goal
#   1       Bad Guy 1 (grub)
#   2       Bad Guy 2 (fly)
BF          S S S                S S S S S S S S S S S S S S S S S S S S S S S                EB
AD         IIIIIII              IIIIIIIIIIIIIIIIIIIIIIIIIIIIIIIIIIIIIIIIIIIIIII               CA
AD                      S S S                I                   EBBBBBBBBBBBBBF     S S S S  CA
AD                     IIIIIII               I                   CAAAAAAAAAAAAAD    S S S S S CA
AD                                           I             S S   CAAAAAAAAAAAAAHF    S S S S  CA
AD                         2       2                      IIIII  CAAAAAAAAAAAAAAD   S S S S S CA
AD                      IIIII                                    CAAAAAAAAAAAAAAHF   IIIIIII  CA
AD         III                          1    1  1        2       CAAAAAAAAAAAAAAAD  S S S S S CA
AD                            1      IIIIIIIIIIIII               CAAAAAAAAAAAAAAAHF  S S S S  CA
AD      1       EBBBBBBBBBBBBBBBF     S S S S S S              * CAAAAAAAAAAAAAAAAD S S S S S CA
AHBBBBBBBBBBBBBBGAAAAAAAAAAAAAAAHBBBBBBBBBBBBBBBBBBBBBBBBBBBBBBBBGAAAAAAAAAAAAAAAAHBBBBBBBBBBBGA